E E E E E E E E E E E E E E E E E E E E E E E E E E E E E E E E A
E 0 A A A A A E A A A A A A A A A E A A A A A A A A A A A A A E E
E A A A A A A E 5 A A A A E E A W E A A A A A A A A A A A A A E E
E E E A E A A E E E A E E E E E W E A A A A A E E A A A A A A E E
E A A A A A A A A A A A A A E E W E A A A A A E E A A E A A A E E
E A A A A A A A A A 3 A A A E E W E E A A A A E E A E A A A A E E
E F E E E E F E F E E E F E E E W W E A A A A E E A E E E A A E E
E F E E E E F E F F E F F F F E W W E A A A A E E A A A A A A E E
E F E E E E F F F F F F E E F E W W A A 1 A A E E E A A A 4 A E E
E F F E E E E E F F F F E E F E W W W W E W W W E E A A A E E E E
E F F E E E E F F F F E E E F E W W W W E W W W E A A A E E E E E
E F F E E E E F F F F F E E F E W W W W W W E E E A A E E W W E E
E F E E E E 2 F F F E F F E F E W W W W W W E A A A E F E W W E E
E F E E E E E E F E E E F F F E E E E E E E E A A E F F E W W E E
E F F E E E E E F F E E E E E E F F F F F F F F E F F F E E E E E
E F F F E E E F F F F F F F F F F F F F F F F E F F F E E E E E E
E F F F F F F F F F F F F F F F F F F F F F E E E E E E E E E E E
E E E E E E E E E E E E E E E E E E E E E E E E E E E E E E E E E
E E E E E E E E E E E E E E E E E E E E E E E E E E E E E E E E A
